HK5NHBGXX_1_TAAGGCGATCTTACGC	TAAGGCGA-TCTTACGC
HK5NHBGXX_1_CGTACTAGTCTTACGC	CGTACTAG-TCTTACGC
HK5NHBGXX_1_AGGCAGAATCTTACGC	AGGCAGAA-TCTTACGC
HK5NHBGXX_1_TCCTGAGCTCTTACGC	TCCTGAGC-TCTTACGC
HK5NHBGXX_1_GGACTCCTTCTTACGC	GGACTCCT-TCTTACGC
HK5NHBGXX_1_TAGGCATGTCTTACGC	TAGGCATG-TCTTACGC
HK5NHBGXX_1_CTCTCTACTCTTACGC	CTCTCTAC-TCTTACGC
HK5NHBGXX_1_CAGAGAGGTCTTACGC	CAGAGAGG-TCTTACGC
HK5NHBGXX_1_GCTACGCTTCTTACGC	GCTACGCT-TCTTACGC
HK5NHBGXX_1_CGAGGCTGTCTTACGC	CGAGGCTG-TCTTACGC
HK5NHBGXX_1_AAGAGGCATCTTACGC	AAGAGGCA-TCTTACGC
HK5NHBGXX_1_GTAGAGGATCTTACGC	GTAGAGGA-TCTTACGC
HK5NHBGXX_1_TAAGGCGAATAGAGAG	TAAGGCGA-ATAGAGAG
HK5NHBGXX_1_CGTACTAGATAGAGAG	CGTACTAG-ATAGAGAG
HK5NHBGXX_1_AGGCAGAAATAGAGAG	AGGCAGAA-ATAGAGAG
HK5NHBGXX_1_TCCTGAGCATAGAGAG	TCCTGAGC-ATAGAGAG
HK5NHBGXX_1_GGACTCCTATAGAGAG	GGACTCCT-ATAGAGAG
HK5NHBGXX_1_TAGGCATGATAGAGAG	TAGGCATG-ATAGAGAG
HK5NHBGXX_1_CTCTCTACATAGAGAG	CTCTCTAC-ATAGAGAG
HK5NHBGXX_1_CAGAGAGGATAGAGAG	CAGAGAGG-ATAGAGAG
HK5NHBGXX_1_GCTACGCTATAGAGAG	GCTACGCT-ATAGAGAG
HK5NHBGXX_1_CGAGGCTGATAGAGAG	CGAGGCTG-ATAGAGAG
HK5NHBGXX_1_AAGAGGCAATAGAGAG	AAGAGGCA-ATAGAGAG
HK5NHBGXX_1_GTAGAGGAATAGAGAG	GTAGAGGA-ATAGAGAG
HK5NHBGXX_1_TAAGGCGAAGAGGATA	TAAGGCGA-AGAGGATA
HK5NHBGXX_1_CGTACTAGAGAGGATA	CGTACTAG-AGAGGATA
HK5NHBGXX_1_AGGCAGAAAGAGGATA	AGGCAGAA-AGAGGATA
HK5NHBGXX_1_TCCTGAGCAGAGGATA	TCCTGAGC-AGAGGATA
HK5NHBGXX_1_GGACTCCTAGAGGATA	GGACTCCT-AGAGGATA
HK5NHBGXX_1_TAGGCATGAGAGGATA	TAGGCATG-AGAGGATA
HK5NHBGXX_1_CTCTCTACAGAGGATA	CTCTCTAC-AGAGGATA
HK5NHBGXX_1_CAGAGAGGAGAGGATA	CAGAGAGG-AGAGGATA
HK5NHBGXX_1_GCTACGCTAGAGGATA	GCTACGCT-AGAGGATA
HK5NHBGXX_1_CGAGGCTGAGAGGATA	CGAGGCTG-AGAGGATA
HK5NHBGXX_1_AAGAGGCAAGAGGATA	AAGAGGCA-AGAGGATA
HK5NHBGXX_1_GTAGAGGAAGAGGATA	GTAGAGGA-AGAGGATA
HK5NHBGXX_1_TAAGGCGATCTACTCT	TAAGGCGA-TCTACTCT
HK5NHBGXX_1_CGTACTAGTCTACTCT	CGTACTAG-TCTACTCT
HK5NHBGXX_1_AGGCAGAATCTACTCT	AGGCAGAA-TCTACTCT
HK5NHBGXX_1_TCCTGAGCTCTACTCT	TCCTGAGC-TCTACTCT
HK5NHBGXX_1_GGACTCCTTCTACTCT	GGACTCCT-TCTACTCT
HK5NHBGXX_1_TAGGCATGTCTACTCT	TAGGCATG-TCTACTCT
HK5NHBGXX_1_CTCTCTACTCTACTCT	CTCTCTAC-TCTACTCT
HK5NHBGXX_1_CAGAGAGGTCTACTCT	CAGAGAGG-TCTACTCT
HK5NHBGXX_1_GCTACGCTTCTACTCT	GCTACGCT-TCTACTCT
HK5NHBGXX_1_CGAGGCTGTCTACTCT	CGAGGCTG-TCTACTCT
HK5NHBGXX_1_AAGAGGCATCTACTCT	AAGAGGCA-TCTACTCT
HK5NHBGXX_1_GTAGAGGATCTACTCT	GTAGAGGA-TCTACTCT
HK5NHBGXX_1_TAAGGCGACTCCTTAC	TAAGGCGA-CTCCTTAC
HK5NHBGXX_1_CGTACTAGCTCCTTAC	CGTACTAG-CTCCTTAC
HK5NHBGXX_1_AGGCAGAACTCCTTAC	AGGCAGAA-CTCCTTAC
HK5NHBGXX_1_TCCTGAGCCTCCTTAC	TCCTGAGC-CTCCTTAC
HK5NHBGXX_1_GGACTCCTCTCCTTAC	GGACTCCT-CTCCTTAC
HK5NHBGXX_1_TAGGCATGCTCCTTAC	TAGGCATG-CTCCTTAC
HK5NHBGXX_1_CTCTCTACCTCCTTAC	CTCTCTAC-CTCCTTAC
HK5NHBGXX_1_CAGAGAGGCTCCTTAC	CAGAGAGG-CTCCTTAC
HK5NHBGXX_1_GCTACGCTCTCCTTAC	GCTACGCT-CTCCTTAC
HK5NHBGXX_1_CGAGGCTGCTCCTTAC	CGAGGCTG-CTCCTTAC
HK5NHBGXX_1_AAGAGGCACTCCTTAC	AAGAGGCA-CTCCTTAC
HK5NHBGXX_1_GTAGAGGACTCCTTAC	GTAGAGGA-CTCCTTAC
HK5NHBGXX_1_TAAGGCGATATGCAGT	TAAGGCGA-TATGCAGT
HK5NHBGXX_1_CGTACTAGTATGCAGT	CGTACTAG-TATGCAGT
HK5NHBGXX_1_AGGCAGAATATGCAGT	AGGCAGAA-TATGCAGT
HK5NHBGXX_1_TCCTGAGCTATGCAGT	TCCTGAGC-TATGCAGT
HK5NHBGXX_1_GGACTCCTTATGCAGT	GGACTCCT-TATGCAGT
HK5NHBGXX_1_TAGGCATGTATGCAGT	TAGGCATG-TATGCAGT
HK5NHBGXX_1_CTCTCTACTATGCAGT	CTCTCTAC-TATGCAGT
HK5NHBGXX_1_CAGAGAGGTATGCAGT	CAGAGAGG-TATGCAGT
HK5NHBGXX_1_GCTACGCTTATGCAGT	GCTACGCT-TATGCAGT
HK5NHBGXX_1_CGAGGCTGTATGCAGT	CGAGGCTG-TATGCAGT
HK5NHBGXX_1_AAGAGGCATATGCAGT	AAGAGGCA-TATGCAGT
HK5NHBGXX_1_GTAGAGGATATGCAGT	GTAGAGGA-TATGCAGT
HK5NHBGXX_1_TAAGGCGATACTCCTT	TAAGGCGA-TACTCCTT
HK5NHBGXX_1_CGTACTAGTACTCCTT	CGTACTAG-TACTCCTT
HK5NHBGXX_1_AGGCAGAATACTCCTT	AGGCAGAA-TACTCCTT
HK5NHBGXX_1_TCCTGAGCTACTCCTT	TCCTGAGC-TACTCCTT
HK5NHBGXX_1_GGACTCCTTACTCCTT	GGACTCCT-TACTCCTT
HK5NHBGXX_1_TAGGCATGTACTCCTT	TAGGCATG-TACTCCTT
HK5NHBGXX_1_CTCTCTACTACTCCTT	CTCTCTAC-TACTCCTT
HK5NHBGXX_1_CAGAGAGGTACTCCTT	CAGAGAGG-TACTCCTT
HK5NHBGXX_1_GCTACGCTTACTCCTT	GCTACGCT-TACTCCTT
HK5NHBGXX_1_CGAGGCTGTACTCCTT	CGAGGCTG-TACTCCTT
HK5NHBGXX_1_AAGAGGCATACTCCTT	AAGAGGCA-TACTCCTT
HK5NHBGXX_1_GTAGAGGATACTCCTT	GTAGAGGA-TACTCCTT
HK5NHBGXX_1_TAAGGCGAAGGCTTAG	TAAGGCGA-AGGCTTAG
HK5NHBGXX_1_CGTACTAGAGGCTTAG	CGTACTAG-AGGCTTAG
HK5NHBGXX_1_AGGCAGAAAGGCTTAG	AGGCAGAA-AGGCTTAG
HK5NHBGXX_1_TCCTGAGCAGGCTTAG	TCCTGAGC-AGGCTTAG
HK5NHBGXX_1_GGACTCCTAGGCTTAG	GGACTCCT-AGGCTTAG
HK5NHBGXX_1_TAGGCATGAGGCTTAG	TAGGCATG-AGGCTTAG
HK5NHBGXX_1_CTCTCTACAGGCTTAG	CTCTCTAC-AGGCTTAG
HK5NHBGXX_1_CAGAGAGGAGGCTTAG	CAGAGAGG-AGGCTTAG
HK5NHBGXX_1_GCTACGCTAGGCTTAG	GCTACGCT-AGGCTTAG
HK5NHBGXX_1_CGAGGCTGAGGCTTAG	CGAGGCTG-AGGCTTAG
HK5NHBGXX_1_AAGAGGCAAGGCTTAG	AAGAGGCA-AGGCTTAG
HK5NHBGXX_1_GTAGAGGAAGGCTTAG	GTAGAGGA-AGGCTTAG
