#Index1	Index2	Name
AATTCAA	CATCCGG	A5KVK:AATTCAACATCCGG
CGCGCAG	TCATGGT	A5KVK:CGCGCAGTCATGGT
AAGGTCT	AGAACCG	A5KVK:AAGGTCTAGAACCG
ACTGGAC	TGGAATA	A5KVK:ACTGGACTGGAATA
AGCAGGT	CAGGAGG	A5KVK:AGCAGGTCAGGAGG
GTACCGG	AATACCT	A5KVK:GTACCGGAATACCT
GGTCAAG	CGAATGC	A5KVK:GGTCAAGCGAATGC
AATGATG	TTCGCAA	A5KVK:AATGATGTTCGCAA
AGTCAGA	AATTCAA	A5KVK:AGTCAGAAATTCAA
AACTAGA	CGCGCAG	A5KVK:AACTAGACGCGCAG
CTATGGC	AAGGTCT	A5KVK:CTATGGCAAGGTCT
CGACGGT	ACTGGAC	A5KVK:CGACGGTACTGGAC
AACCAAG	AGCAGGT	A5KVK:AACCAAGAGCAGGT
CGGCGTA	GTACCGG	A5KVK:CGGCGTAGTACCGG
GCAGTCC	GGTCAAG	A5KVK:GCAGTCCGGTCAAG
CTCGCGC	AATGATG	A5KVK:CTCGCGCAATGATG
CTGCGAC	AGTCAGA	A5KVK:CTGCGACAGTCAGA
ACGTATG	AACTAGA	A5KVK:ACGTATGAACTAGA
ATACTGA	CTATGGC	A5KVK:ATACTGACTATGGC
TACTTAG	CGACGGT	A5KVK:TACTTAGCGACGGT
AAGCTAA	AACCAAG	A5KVK:AAGCTAAAACCAAG
GACGGCG	CGGCGTA	A5KVK:GACGGCGCGGCGTA
AGAAGAC	GCAGTCC	A5KVK:AGAAGACGCAGTCC
GTCCGGC	CTCGCGC	A5KVK:GTCCGGCCTCGCGC
TTCAACC	TCAGCTT	A5KVK:TTCAACCTCAGCTT
TTAACTC	AGAGCGC	A5KVK:TTAACTCAGAGCGC
TAGTCTA	GCCTACG	A5KVK:TAGTCTAGCCTACG
TGCATGA	TAATCAT	A5KVK:TGCATGATAATCAT
AATAAGC	AACCTGC	A5KVK:AATAAGCAACCTGC
AGCCTTG	GACGATT	A5KVK:AGCCTTGGACGATT
CCAACCT	TAGGCCG	A5KVK:CCAACCTTAGGCCG
GCAGAAG	GGCATAG	A5KVK:GCAGAAGGGCATAG
AGAATTA	TTCAACC	A5KVK:AGAATTATTCAACC
CAGCATC	TTAACTC	A5KVK:CAGCATCTTAACTC
TTCTAGG	TAGTCTA	A5KVK:TTCTAGGTAGTCTA
CCTCTAG	TGCATGA	A5KVK:CCTCTAGTGCATGA
CCGGATA	AATAAGC	A5KVK:CCGGATAAATAAGC
GCCGCCT	AGCCTTG	A5KVK:GCCGCCTAGCCTTG
AACGACC	CCAACCT	A5KVK:AACGACCCCAACCT
CCAGCGG	GCAGAAG	A5KVK:CCAGCGGGCAGAAG
TAGTTCC	AGAATTA	A5KVK:TAGTTCCAGAATTA
TGGCAAT	CAGCATC	A5KVK:TGGCAATCAGCATC
CGTATAT	TTCTAGG	A5KVK:CGTATATTTCTAGG
GCTAATC	CCTCTAG	A5KVK:GCTAATCCCTCTAG
GACTTCT	CCGGATA	A5KVK:GACTTCTCCGGATA
GTACTAT	GCCGCCT	A5KVK:GTACTATGCCGCCT
CGAGATC	AACGACC	A5KVK:CGAGATCAACGACC
CGCAGCC	CCAGCGG	A5KVK:CGCAGCCCCAGCGG
TCGCAGG	TAGTTCC	A5KVK:TCGCAGGTAGTTCC
CTCTGCA	TGGCAAT	A5KVK:CTCTGCATGGCAAT
CCTAGGT	CGTATAT	A5KVK:CCTAGGTCGTATAT
GGATCAA	GCTAATC	A5KVK:GGATCAAGCTAATC
GCAAGAT	GACTTCT	A5KVK:GCAAGATGACTTCT
ATGGAGA	GTACTAT	A5KVK:ATGGAGAGTACTAT
CTCGATG	CGAGATC	A5KVK:CTCGATGCGAGATC
GCTCGAA	CGCAGCC	A5KVK:GCTCGAACGCAGCC
AGTCAGA	CATCCGG	A5KVK:AGTCAGACATCCGG
AACTAGA	TCATGGT	A5KVK:AACTAGATCATGGT
CTATGGC	AGAACCG	A5KVK:CTATGGCAGAACCG
CGACGGT	TGGAATA	A5KVK:CGACGGTTGGAATA
AACCAAG	CAGGAGG	A5KVK:AACCAAGCAGGAGG
CGGCGTA	AATACCT	A5KVK:CGGCGTAAATACCT
GCAGTCC	CGAATGC	A5KVK:GCAGTCCCGAATGC
CTCGCGC	TTCGCAA	A5KVK:CTCGCGCTTCGCAA
CTGCGAC	AATTCAA	A5KVK:CTGCGACAATTCAA
ACGTATG	CGCGCAG	A5KVK:ACGTATGCGCGCAG
ATACTGA	AAGGTCT	A5KVK:ATACTGAAAGGTCT
CAGGAGG	CCGATTG	A5KVK:CAGGAGGCCGATTG
AATACCT	ATGCCGC	A5KVK:AATACCTATGCCGC
CGAATGC	CAGTACT	A5KVK:CGAATGCCAGTACT
TTCGCAA	AATAGTA	A5KVK:TTCGCAAAATAGTA
ACCAACT	TCGCAGG	A5KVK:ACCAACTTCGCAGG
CCGGTAC	CTCTGCA	A5KVK:CCGGTACCTCTGCA
AACTCCG	CCTAGGT	A5KVK:AACTCCGCCTAGGT
TTGAAGT	GGATCAA	A5KVK:TTGAAGTGGATCAA
ACTATCA	GCAAGAT	A5KVK:ACTATCAGCAAGAT
TTGGATC	ATGGAGA	A5KVK:TTGGATCATGGAGA
CGACCTG	CTCGATG	A5KVK:CGACCTGCTCGATG
TAATGCG	GCTCGAA	A5KVK:TAATGCGGCTCGAA
AGGTACC	ACCAACT	A5KVK:AGGTACCACCAACT
TGCGTCC	CCGGTAC	A5KVK:TGCGTCCCCGGTAC
GAATCTC	AACTCCG	A5KVK:GAATCTCAACTCCG
CATGCTC	TTGAAGT	A5KVK:CATGCTCTTGAAGT
ACGCAAC	ACTATCA	A5KVK:ACGCAACACTATCA
GCATTGG	TTGGATC	A5KVK:GCATTGGTTGGATC
GATCTCG	CGACCTG	A5KVK:GATCTCGCGACCTG
CAATATG	TAATGCG	A5KVK:CAATATGTAATGCG
TGACGTC	AGGTACC	A5KVK:TGACGTCAGGTACC
GATGCCA	TGCGTCC	A5KVK:GATGCCATGCGTCC
CAATTAC	GAATCTC	A5KVK:CAATTACGAATCTC
AGATAGG	CATGCTC	A5KVK:AGATAGGCATGCTC
CCGATTG	ACGCAAC	A5KVK:CCGATTGACGCAAC
ATGCCGC	GCATTGG	A5KVK:ATGCCGCGCATTGG
CAGTACT	GATCTCG	A5KVK:CAGTACTGATCTCG
AATAGTA	CAATATG	A5KVK:AATAGTACAATATG
CATCCGG	TGACGTC	A5KVK:CATCCGGTGACGTC
TCATGGT	GATGCCA	A5KVK:TCATGGTGATGCCA
AGAACCG	CAATTAC	A5KVK:AGAACCGCAATTAC
TGGAATA	AGATAGG	A5KVK:TGGAATAAGATAGG
GACGATT	GACGGCG	A5KVK:GACGATTGACGGCG
